"a" = (/turf/space,/area/space)
"b" = (/turf/simulated/wall/r_wall,/area/space)
"c" = (/obj/structure/prop/misc/display_case,/turf/simulated/floor/tiled/old_tile,/area/space)
"d" = (/obj/structure/closet/cabinet,/turf/simulated/floor/tiled/old_tile,/area/space)
"e" = (/obj/structure/table,/turf/simulated/floor/tiled/old_tile,/area/space)
"f" = (/obj/structure/sign/kiddieplaque{pixel_y = 32},/obj/structure/showcase,/turf/simulated/floor/tiled/old_tile,/area/space)
"g" = (/obj/structure/prop/tech/console/bsod/error,/turf/simulated/floor/tiled/old_tile,/area/space)
"h" = (/obj/structure/prop/tech/console/bsod,/turf/simulated/floor/tiled/old_tile,/area/space)
"i" = (/obj/structure/prop/tech/console/crew/warning,/turf/simulated/floor/tiled/old_tile,/area/space)
"j" = (/turf/simulated/floor/tiled/old_tile,/area/space)
"k" = (/turf/simulated/floor/carpet/purcarpet,/area/space)
"l" = (/obj/structure/table/glass,/turf/simulated/floor/carpet/purcarpet,/area/space)
"m" = (/obj/structure/bed/chair/office/light,/turf/simulated/floor/carpet/purcarpet,/area/space)
"n" = (/obj/structure/table,/turf/simulated/floor/carpet/purcarpet,/area/space)
"o" = (/obj/structure/bed/chair{dir = 1},/turf/simulated/floor/carpet/purcarpet,/area/space)
"p" = (/obj/machinery/disposal,/turf/simulated/floor/tiled/old_tile,/area/space)
"q" = (/obj/structure/coatrack,/turf/simulated/floor/tiled/old_tile,/area/space)
"r" = (/obj/structure/wall_frame,/obj/structure/grille,/obj/structure/window/reinforced,/obj/structure/window/reinforced{dir = 8},/obj/structure/window/reinforced{dir = 1; health = 1e+006},/turf/simulated/floor/plating,/area/space)
"s" = (/obj/structure/wall_frame,/obj/structure/grille,/obj/structure/window/reinforced,/obj/structure/window/reinforced{dir = 1; health = 1e+006},/turf/simulated/floor/plating,/area/space)
"t" = (/obj/structure/wall_frame,/obj/structure/grille,/obj/structure/window/reinforced,/obj/structure/window/reinforced{dir = 4; health = 1e+006},/obj/structure/window/reinforced{dir = 1; health = 1e+006},/turf/simulated/floor/plating,/area/space)

(1,1,1) = {"
bbbbbbbbbbbbbbbbbbbbbbbbb
bcdefghibaaaaaaaaaaaaaaab
bjjjjjjjbaaaaaaaaaaaaaaab
bjklmlkjbaaaaaaaaaaaaaaab
bjklnlkjbaaaaaaaaaaaaaaab
bjkoookjbaaaaaaaaaaaaaaab
bpjjjjjqbaaaaaaaaaaaaaaab
brstjrstbaaaaaaaaaaaaaaab
baaaaaaaaaaaaaaaaaaaaaaab
baaaaaaaaaaaaaaaaaaaaaaab
baaaaaaaaaaaaaaaaaaaaaaab
baaaaaaaaaaaaaaaaaaaaaaab
baaaaaaaaaaaaaaaaaaaaaaab
baaaaaaaaaaaaaaaaaaaaaaab
baaaaaaaaaaaaaaaaaaaaaaab
baaaaaaaaaaaaaaaaaaaaaaab
baaaaaaaaaaaaaaaaaaaaaaab
baaaaaaaaaaaaaaaaaaaaaaab
baaaaaaaaaaaaaaaaaaaaaaab
baaaaaaaaaaaaaaaaaaaaaaab
baaaaaaaaaaaaaaaaaaaaaaab
baaaaaaaaaaaaaaaaaaaaaaab
baaaaaaaaaaaaaaaaaaaaaaab
baaaaaaaaaaaaaaaaaaaaaaab
bbbbbbbbbbbbbbbbbbbbbbbbb
"}
